####################
#         #        #
#         #        #
#         #        #
#      *  #  *     #
#     #########    #
#                  #
#                  #
#                  #
######         #####
#                  #
#                  #
#                  #
#                  #
#                  #
#                  #
#    # #     ##    #
#    #        #    #
#    #    D   #    #
####################