####################
#              #  *#
#      ##      #   #
#                  #
#         #        #
#         #        #
#         #        #
#  *      #        #
####### #     ######
#   #   #          #
# * #     #        #
#         #        #
#         #        #
#                  #
#                  #
#         *        #
#                  #
#                  #
#                  #
####################