####################
#              #  *#
#      ##      #   #
#                  #
#         #        #
#         #        #
#         #        #
#       #          #
####### #     ######
#   #   #          #
# * #     #        #
#         #        #
#         #        #
#   #              #
#   #              #
#                  #
#                  #
#                  #
#                  #
####################