####################
#                  #
#                  #
#               #  #
#         #     #  #
#         #        #
#         #        #
#       #          #
####### #     ######
#       #          #
#         #        #
#         #        #
#         #        #
#   #              #
#                  #
#                  #
#                  #
#   #              #
#   #              #
####################